OOOOOOOOOOOOOOO
OXO        O  U
O O O O    O OO
O O O O    O  O
O O O O    OO O
O O O O    O  O
O O O OOOOOO OO
O O O         O
O O OOOOOOOOOOO
O O           O
O O O   OOO   O
O OOOOO   O   O
O O  O O OOO  O
O             O
OOOOOOOOOOOOOOO
